R 1000 800
NO ./pics/redbrick.xpm
SO ./pics/redbrick.xpm
WE            ./pics/purplestone.xpm          
EA     ./pics/purplestone.xpm

S ./pics/pillar.xpm

C 0, 10,0
F 52,58,65

         111111111111111111111111111
         100000000011000000000002111
         111011000001110000000000001
         10010000000000000000E0000011
111111111011000001110000000000001111
10000000001100000111011111111101111
1111011111111101110000001000110111
1111011111111101110101001000111111
11000000111101011100000010001
1000200001  10001100000010001
10000000001100001101012000001
11000001110101011111011110011
11110111 1110101 101111010001
11111111 1111111 111111111111