R 1920 1080
NO ./pics/eagle.xpm
SO ./pics/redbrick.xpm
WE ./pics/purplestone.xpm
EA ./pics/greystone.xpm

S ./pics/barrel.xpm
F 52,58,65
C 0,0,126

         1111111111111111111111111
  111    1000000000110000000000001
  101    1011000001110000000000001
  111    1001000000000000000000001
      1111011000001110000000000001
1111111000011000001110111111111111
11110111111111011100000010001
11110111111111011101010010001
11000000001110011100000010001
1000200001   1001100000000001
1000000001   1001101010010001
11000001101111011111011110N0111
11110111 1110101 101111010001
11111111 1111111 111111111111