R 1920 1080
NO ./pics/eagle.xpm
SO ./pics/redbrick.xpm
WE ./pics/purplestone.xpm
EA ./pics/greystone.xpm
S ./pics/barrel.xpm



C 0,  0,  126
F 52,58,  65




        1111111111111111111111111
        1000000000110000000000001
        1011000001110000002000001
        1001000000000000000000001
111111111011000001110000000000001
100000000011000001110111111111111
11110111111111011100000010001
11110111111111011101010010001
11000000110101011100000010001
10002000000000001100000010001
10000000000000001101010000W01
1100000111010101111101111000111
11110111 1110101 101111010001
11111111 1111111 111111111111