R 1920 1080
NO    ./pics/Slime1.xpm
SO      ./pics/Sp3.xpm    
WE            ./pics/Red3.xpm          
EA     ./pics/Grey8.xpm

S ./pics/pillar.xpm

C 0,0,126
F 52,58,65

         111111111111111111111111111
         100000000011000222000000111
         111011000001110000000020001
         10010000000000000000E0000011
111111111011000001110000000000001111
10000000001100000111011111111101111
1111011111111101110000001000110111
1111011111111101110101001000111111
11000000111101011100000010001
1000000001  10001100000010001
10000000001100001101010000001
11000001110101011111011110011
11110111 1110101 101111010001
11111111 1111111 111111111111