R 1920 1080

NO ./path_to_the_north_texture 
SO ./path_to_the_south_texture
WE ./path_to_the_west_texture
EA ./path_to_the_east_texture

S ./path_to_the_sprite_texture
F 220,100,0     
C 225,30,0   

111111111111111111111111111111111111111
100000000000000000000000000000000000001
101111100000100000000100001000000100001
101000000001010000001010001100001010001
101000000010001000011111001010011111001
101111100100000000100000101100100000101
100E00000000000000000000000000000000001
110000101001111100000100001010100010101
101001001010010100001010000100100010001
100100001100011100010001000100111110101
101000001010010000111111100100100010101
110000001001010001000000010100100010101
111111111111111111111111111111111111111