R 1000 800
NO ./pics/redbrick.xpm
SO ./pics/redbrick.xpm
WE            ./pics/purplestone.xpm          
EA     ./pics/purplestone.xpm

S ./pics/pillar.xpm

C 0, 10,0
F 52,58,65

         111111111111111111111111111
         100000000011000000000002111
         111011000001110000000000001
         1001000000000000N0000000111
111111111011000001110000000000001
100000000011000001110111111111011
11110111111111011100000010001
11110111111111011101010010001
 11000000111101011100000010001         1    1    1
1000200001  10001100000010001      111101
10000000001100001101012000001          1
110000011101010111110111100111
11110111 1110101 101111010001
11111111 1111111 111111111111